season,iowa_name,iowa_conf_name,iowa_points,iowa_fgm,iowa_fga,iowa_thpm,iowa_thpa,iowa_twpm,iowa_twpa,iowa_ftm,iowa_fta,opp_name,opp_conf_name,opp_points,opp_fgm,opp_fga,opp_thpm,opp_thpa,opp_twpm,opp_twpa,opp_ftm,opp_fta
2015,Hawkeyes,Big Ten,78,27,64,5,21,22,43,19,26,Seminoles,Atlantic Coast,75,29,76,5,23,24,53,12,15
2015,Hawkeyes,Big Ten,83,27,54,11,20,16,34,18,28,Boilermakers,Big Ten,71,27,64,9,23,18,41,8,15
2015,Hawkeyes,Big Ten,78,26,67,8,19,18,48,18,27,Hoosiers,Big Ten,81,30,59,11,22,19,37,10,20
2015,Hawkeyes,Big Ten,77,23,53,7,17,16,36,24,32,Cornhuskers,Big Ten,66,25,58,7,20,18,38,9,16
2015,Hawkeyes,Big Ten,59,18,55,5,18,13,37,18,25,Badgers,Big Ten,67,25,52,10,23,15,29,7,12
2015,Hawkeyes,Big Ten,103,40,72,12,28,28,44,11,20,Eagles,Mid Eastern Athletic,68,24,74,8,28,16,46,12,22
2015,Hawkeyes,Big Ten,82,31,61,10,22,21,39,10,11,Wolverines,Big Ten,71,25,54,10,28,15,26,11,14
2015,Hawkeyes,Big Ten,75,24,57,6,19,18,38,21,30,Golden Gophers,Big Ten,71,25,65,6,22,19,43,15,20
2015,Hawkeyes,Big Ten,85,32,70,11,30,21,40,10,13,Golden Eagles,Ohio Valley,63,22,57,8,26,14,31,11,16
2015,Hawkeyes,Big Ten,83,27,56,6,13,21,43,23,31,Spartans,Big Ten,70,27,64,3,13,24,51,13,20
2015,Hawkeyes,Big Ten,90,33,66,10,23,23,43,14,19,Leathernecks,Summit League,56,23,66,6,22,17,44,4,7
2015,Hawkeyes,Big Ten,73,25,54,6,17,19,37,17,26,Nittany Lions,Big Ten,49,21,69,1,20,20,49,6,12
2015,Hawkeyes,Big Ten,76,24,59,7,24,17,35,21,28,Runnin' Bulldogs,Big South,59,19,60,6,23,13,37,15,21
2015,Hawkeyes,Big Ten,95,34,72,12,25,22,47,15,19,Kangaroos,Western Athletic,75,29,66,7,18,22,48,10,16
2015,Hawkeyes,Big Ten,85,25,59,7,19,18,40,28,36,Wildcats,Big Ten,71,26,62,11,30,15,32,8,14
2015,Hawkeyes,Big Ten,70,28,60,8,21,20,39,6,8,Bulldogs,Missouri Valley,64,24,60,11,26,13,34,5,8
2015,Hawkeyes,Big Ten,84,28,52,8,18,20,34,20,24,Shockers,American Athletic,61,21,59,6,22,15,37,13,17
2015,Hawkeyes,Big Ten,62,25,66,6,24,19,42,6,9,Fighting Irish,Atlantic Coast,68,25,55,8,25,17,30,10,15
2015,Hawkeyes,Big Ten,66,25,62,8,20,17,42,8,10,Fighting Illini,Big Ten,68,26,58,10,23,16,35,6,6
2014,Hawkeyes,Big Ten,59,21,49,4,14,17,35,13,16,Golden Gophers,Big Ten,64,23,57,6,19,17,38,12,19
2013,Hawkeyes,Big Ten,63,24,54,6,17,18,37,9,14,Fighting Illini,Big Ten,66,25,54,7,19,18,35,9,12
2013,Hawkeyes,Big Ten,67,22,48,1,6,21,42,22,39,Cornhuskers,Big Ten,57,20,67,5,18,15,49,12,18
2014,Hawkeyes,Big Ten,67,24,57,3,19,21,38,16,22,Braves,Southwestern Athletic,44,19,58,0,8,19,50,6,11
2013,Hawkeyes,Big Ten,93,29,51,8,14,21,37,27,36,Wildcats,Big Ten,67,23,59,5,24,18,35,16,25
2014,Hawkeyes,Big Ten,75,28,71,7,20,21,51,12,13,Cyclones,Big 12,90,34,64,12,27,22,37,10,13
2013,Hawkeyes,Big Ten,74,31,64,4,14,27,50,8,9,Badgers,Big Ten,79,30,63,8,24,22,39,11,13
2013,Hawkeyes,Big Ten,83,21,56,3,14,18,42,38,49,Mavericks,Summit League,75,28,71,8,28,20,43,11,16
2014,Hawkeyes,Big Ten,72,25,61,5,14,20,47,17,26,Waves,West Coast,61,19,51,7,27,12,24,16,26
2013,Hawkeyes,Big Ten,69,27,60,3,20,24,40,12,19,Buckeyes,Big Ten,76,25,49,7,16,18,33,19,24
2014,Hawkeyes,Big Ten,81,30,59,8,17,22,42,13,22,Scarlet Knights,Big Ten,47,18,55,5,22,13,33,6,13
2013,Hawkeyes,Big Ten,92,34,70,4,11,30,59,20,27,Knights,Northeast,59,21,65,7,22,14,43,10,14
2013,Hawkeyes,Big Ten,82,31,67,4,12,27,55,16,24,Seahawks,Colonial,39,16,72,2,23,14,49,5,10
2014,Hawkeyes,Big Ten,87,30,56,9,20,21,36,18,20,Bison,Summit League,56,18,67,10,27,8,40,10,14
2014,Hawkeyes,Big Ten,70,17,44,5,20,12,24,31,38,Cornhuskers,Big Ten,59,22,48,2,14,20,34,13,21
2014,Hawkeyes,Big Ten,68,21,48,6,14,15,34,20,30,Fighting Illini,Big Ten,60,19,57,7,21,12,36,15,16
2014,Hawkeyes,Big Ten,69,25,60,8,25,17,35,11,16,Wildcats,Big Ten,52,16,42,8,20,8,22,12,14
2013,Hawkeyes,Big Ten,94,29,59,9,20,20,39,27,37,Golden Gophers,Big Ten,73,26,58,5,16,21,42,16,24
2014,Hawkeyes,Big Ten,76,24,47,3,9,21,38,25,35,Buckeyes,Big Ten,67,23,60,7,18,16,42,14,21
2013,Hawkeyes,Big Ten,98,33,58,7,13,26,45,25,29,Fighting Irish,Atlantic Coast,93,35,68,8,17,27,51,15,19
2013,Hawkeyes,Big Ten,83,26,60,5,16,21,44,26,36,Boilermakers,Big Ten,76,28,57,6,18,22,39,14,21
2014,Hawkeyes,Big Ten,70,25,54,5,17,20,37,15,19,Huskies,Mid-American,49,17,61,6,23,11,38,9,12
2014,Hawkeyes,Big Ten,90,29,61,9,21,20,40,23,33,Pirates,Mid Eastern Athletic,56,20,59,4,18,16,41,12,17
2013,Hawkeyes,Big Ten,109,35,68,7,17,28,51,32,43,Hawks,Mid Eastern Athletic,63,24,75,4,25,20,50,11,18
2014,Hawkeyes,Big Ten,71,27,42,5,11,22,31,12,16,Terrapins,Big Ten,55,18,49,7,23,11,26,12,16
2014,Hawkeyes,Big Ten,63,23,48,4,7,19,41,13,20,Badgers,Big Ten,74,23,52,7,19,16,33,21,26
2013,Hawkeyes,Big Ten,86,26,66,6,18,20,48,28,40,Quakers,Ivy,55,21,58,3,23,18,35,10,16
2013,Hawkeyes,Big Ten,85,29,61,10,17,19,44,17,22,Wolverines,Big Ten,67,22,52,9,25,13,27,14,18
2014,Hawkeyes,Big Ten,61,22,51,2,12,20,39,15,24,Spartans,Big Ten,75,27,53,12,17,15,36,9,12
2013,Hawkeyes,Big Ten,69,18,48,3,12,15,36,30,43,Spartans,Big Ten,71,25,59,10,29,15,30,11,20
2014,Hawkeyes,Big Ten,80,23,60,8,20,15,40,26,28,Ospreys,Atlantic Sun,70,26,57,12,26,14,31,6,7
2014,Hawkeyes,Big Ten,58,15,57,3,15,12,42,25,31,Nittany Lions,Big Ten,67,22,56,6,15,16,41,17,24
2014,Hawkeyes,Big Ten,83,35,69,6,16,29,53,7,10,Wildcats,Atlantic 10,52,21,63,6,28,15,35,4,10
2013,Hawkeyes,Big Ten,62,20,62,6,24,14,38,16,18,Wildcats,Big Ten,67,23,44,11,23,12,21,10,13
2013,Hawkeyes,Big Ten,86,29,47,10,17,19,30,18,27,Golden Lions,Southwestern Athletic,61,22,65,8,26,14,39,9,17
2017,Hawkeyes,Big Ten,92,35,67,6,22,29,45,16,21,Thunderbirds,Big Sky,64,24,61,8,26,16,35,8,14
2017,Hawkeyes,Big Ten,64,26,59,6,18,20,41,6,12,Boilermakers,Big Ten,87,33,59,20,33,13,26,1,4
2016,Hawkeyes,Big Ten,84,28,60,5,12,23,48,23,34,Fighting Hawks,Big Sky,73,27,65,7,21,20,44,12,14
2016,Hawkeyes,Big Ten,89,29,51,8,20,21,31,23,35,Hornets,Mid Eastern Athletic,57,16,66,6,24,10,42,19,26
2016,Hawkeyes,Big Ten,66,21,54,7,21,14,33,17,22,Fighting Illini,Big Ten,70,27,57,9,25,18,32,7,14
2016,Hawkeyes,Big Ten,89,27,67,14,34,13,33,21,27,Mavericks,Summit League,98,34,71,9,25,25,46,21,27
2017,Hawkeyes,Big Ten,92,32,68,11,29,21,39,17,33,Hornets,Southwestern Athletic,58,24,64,4,14,20,50,6,11
2016,Hawkeyes,Big Ten,78,26,55,9,22,17,33,17,24,Cyclones,Big 12,64,25,70,8,30,17,40,6,9
2017,Hawkeyes,Big Ten,85,31,60,6,18,25,42,17,22,Badgers,Big Ten,67,26,65,4,18,22,47,11,14
2017,Hawkeyes,Big Ten,93,36,69,9,20,27,49,12,19,Spartans,Big Ten,96,32,57,8,17,24,40,24,29
2017,Hawkeyes,Big Ten,91,28,63,13,32,15,31,22,28,Jaguars,Southwestern Athletic,60,21,70,3,21,18,49,15,20
2016,Hawkeyes,Big Ten,68,23,53,6,20,17,33,16,23,Scarlet Knights,Big Ten,62,28,73,4,15,24,58,2,4
2016,Hawkeyes,Big Ten,96,26,56,5,24,21,32,39,47,Hoosiers,Big Ten,90,32,68,10,29,22,39,16,19
2016,Hawkeyes,Big Ten,86,33,69,11,19,22,50,9,15,Wolverines,Big Ten,83,34,74,12,35,22,39,3,5
2016,Hawkeyes,Big Ten,87,35,62,10,23,25,39,7,15,Coyotes,Summit League,75,25,59,7,17,18,42,18,25
2016,Hawkeyes,Big Ten,91,30,60,7,22,23,38,24,34,Owls,Atlantic Sun,74,30,70,8,15,22,55,6,15
2016,Hawkeyes,Big Ten,81,27,58,9,19,18,39,18,23,Cornhuskers,Big Ten,70,27,64,3,20,24,44,13,16
2017,Hawkeyes,Big Ten,94,33,60,12,25,21,35,16,21,Golden Gophers,Big Ten,80,30,67,7,25,23,42,13,20
2017,Hawkeyes,Big Ten,68,25,52,6,15,19,37,12,17,Wolverines,Big Ten,75,28,57,11,25,17,32,8,10
2016,Hawkeyes,Big Ten,83,34,60,6,14,28,46,9,18,Boilermakers,Big Ten,78,23,53,11,28,12,25,21,25
2017,Hawkeyes,Big Ten,73,28,55,4,12,24,43,13,21,Nittany Lions,Big Ten,77,28,64,12,23,16,41,9,11
2016,Hawkeyes,Big Ten,116,42,87,18,43,24,44,14,20,Tigers,Mid Eastern Athletic,84,30,68,11,28,19,40,13,24
2017,Hawkeyes,Big Ten,81,29,68,7,17,22,51,16,23,Buckeyes,Big Ten,92,35,66,7,20,28,46,15,23
2017,Hawkeyes,Big Ten,95,31,52,12,22,19,30,21,35,Cougars,Western Athletic,62,23,61,6,26,17,35,10,18
2017,Hawkeyes,Big Ten,82,27,49,9,21,18,28,19,22,Hoosiers,Big Ten,84,32,57,14,24,18,33,6,9
2016,Hawkeyes,Big Ten,92,34,63,16,30,18,33,8,19,Horned Frogs,Big 12,94,36,71,10,24,26,47,12,18
2016,Hawkeyes,Big Ten,90,31,65,12,21,19,44,16,19,Nittany Lions,Big Ten,79,31,70,8,28,23,42,9,12
2017,Hawkeyes,Big Ten,77,25,59,10,29,15,30,17,23,Wildcats,Big Ten,70,27,58,13,25,14,33,3,7
2016,Hawkeyes,Big Ten,83,28,61,8,21,20,40,19,32,Pirates,Big East,91,33,65,8,17,25,48,17,31
2016,Hawkeyes,Big Ten,76,25,70,7,28,18,42,19,25,Terrapins,Big Ten,84,30,53,11,23,19,30,13,18
2016,Hawkeyes,Big Ten,95,36,73,6,23,30,50,17,28,Hatters,Atlantic Sun,68,25,72,8,33,17,39,10,16
2016,Hawkeyes,Big Ten,85,32,64,10,23,22,41,11,20,Buckeyes,Big Ten,72,27,63,7,22,20,41,11,17
2016,Hawkeyes,Big Ten,95,32,63,11,29,21,34,20,30,Vaqueros,Western Athletic,67,23,67,9,27,14,40,12,14
2016,Hawkeyes,Big Ten,73,29,65,9,26,20,39,6,10,Hoosiers,Big Ten,95,35,58,12,20,23,38,13,19
2017,Hawkeyes,Big Ten,90,37,67,6,18,31,49,10,15,Bulldogs,Missouri Valley,64,24,55,9,26,15,29,7,9
2016,Hawkeyes,Big Ten,69,28,58,6,20,22,38,7,9,Panthers,Missouri Valley,46,15,56,6,26,9,30,10,14
2016,Hawkeyes,Big Ten,41,15,48,6,23,9,25,5,10,Cavaliers,Atlantic Coast,74,29,60,8,17,21,43,8,13
2014,Hawkeyes,Big Ten,57,16,54,4,14,12,40,21,28,Longhorns,Big 12,71,27,59,6,17,21,42,11,16
2017,Hawkeyes,Big Ten,96,27,48,8,14,19,34,34,41,Fighting Illini,Big Ten,87,32,66,14,30,18,36,9,12
2015,Hawkeyes,Big Ten,72,24,69,7,28,17,41,17,22,Owls,American Athletic,70,30,66,4,18,26,48,6,9
2014,Hawkeyes,Big Ten,77,31,71,9,30,22,41,6,9,Lancers,Big South,44,15,48,4,10,11,38,10,14
2013,Hawkeyes,Big Ten,103,38,61,9,21,29,40,18,22,Wildcats,Southland,41,14,54,3,23,11,31,10,12
2014,Hawkeyes,Big Ten,77,29,65,7,25,22,40,12,15,Retrievers,America East,47,19,57,4,19,15,38,5,10
2017,Hawkeyes,Big Ten,85,25,46,8,20,17,26,27,36,Tigers,Southwestern Athletic,74,29,68,10,24,19,44,6,6
2017,Hawkeyes,Big Ten,98,36,62,12,26,24,36,14,21,Huskies,Mid-American,82,30,69,8,22,22,47,7,10
2017,Hawkeyes,Big Ten,71,22,60,6,19,16,41,21,26,Ragin' Cajuns,Sun Belt,80,30,61,5,21,25,40,15,22
2016,Hawkeyes,Big Ten,92,30,55,11,23,19,32,21,24,Tigers,American Athletic,100,40,72,7,18,33,54,13,20